#######
#...###
#..$..#
##*.o.#
##...@#
#######