#######
#..*..#
#.....#
##.#.##
##$@o##
##...##
#######