#######
#..####
#.o.o.#
#.$$#@#
##....#
#######