########
#...####
#.o...##
##*#$..#
#.o#.$.#
#.@##.##
#.....##
########