#######
#.....#
#.#.#.#
#o.$*@#
#...###
#######